5 5
3 3
1 1
1 2 0 4 5
2 3 4 5 1
0 0 0 0 2
4 3 2 1 0
5 5 4 3 1